Sam Worthington : Jake Sully
Zoe Saldana : Ney'tiri
Sigourney Weaver : Kiri
Stephen Lang : Colonel Miles Quaritch
Kate Winslet : Ronal
Cliff Curtis : Tonowari
Joel David Moore : Norm Spellman
CCH Pounder : Mo'at
Edie Falco : General Ardmore
Jemaine Clement : Dr. Ian Garvin
Brendan Cowell : Capt. Mick Scoresby
Britain Dalton : Lo'ak
Jamie Flatters : Neteyam
Trinity Jo-Li Bliss : Tuktirey
Jack Champion : Spider
Bailey Bass : Tsireya
Filip Geljo : Aonung
Duane Evans Jr. : Rotxo
Giovanni Ribisi : Selfridge
Dileep Rao : Dr. Max Patel
Matt Gerald : Corporal Lyle Wainfleet
Robert Okumu : Ta'unui Olecthan
Keston John : Tarsem
Kevin Dorman : Recom Mansk
Alicia Vela-Bailey : Recom Zdinarsik
Sean Anthony Moran : Recom Fike
Johnny Alexander : Recom Ja
Victor Lopez : Recom Lopez
Maria Walker : Recom Walker
Phil Brown : Stringer











