Daisy Ridley : Rey
John Boyega : Finn
Adam Driver : Kylo Ren
Harrison Ford : Han Solo
Oscar Isaac : Poe Dameron
Carrie Fisher : Princesse Leia
Mark Hamill : Luke Skywalker
Lupita Nyong'o : Maz Kanata
Andy Serkis : Suprême Leader Snoke
Peter Mayhew : Chewbacca
Gwendoline Christie : Captaine Phasma
Domhnall Gleeson : Général Hux
Anthony Daniels : C-3PO
Kenny Baker : R2-D2
Max von Sydow : Lor San Tekka
Maisie Richardson-Sellers : Korr Sella
Greg Grunberg : Snap Wexley
Crystal Clarke : Ensign Goode
Yayan Ruhian : Tasu Leech
Iko Uwais : Razoo Quin-Fee
Morgan Dameron : Commodore Meta
Pip Andersen : Chef Stormtrooper
Ken Leung : Amiral Statura
Miltos Yerolemou : Patron de bar
Warwick Davis : Wollivan
Kiran Shah : Teedo
Jessica Henwick : Jessika Pava
Mark Stanley : Chevalier de Ren
Simon Pegg : Unkar Plutt
Mike Quinn : Nien Nunb
Dixie Arnold : Soldat de la résistance
Billie Lourd : Lieutenant Connix
Raymond Mamrak : Stormtrooper
Johnny Lynch : Stormtrooper
Dante Briggins : Stormtrooper
Phoenix James : Stormtrooper
Mark Preston : Stormtrooper
Michael Giacchino : Un stormtrooper
James McArdle : Niv Lek
Gerald W. Abrams : Capitaine Cypress
Daniel Craig : Stormtrooper
Cailey Fleming : Rey enfant
Hannah John-Kamen : First Order Officer
Liang Yang : FN-2199