Pedro Pascal : The Mandalorian , Din Djarin
Temuera Morrison : Boba Fett
Katy O'Brian : Comms Officer
Gina Carano : Cara Dune
Giancarlo Esposito : Moff Gideon
Gabriel Ebert : Gunnery Officer
Ming-Na Wen : Fennec Shand
Misty Rosas : Frog Lady
Paul Sun-Hyung Lee : Cpt. Carson Teva
Sasha Banks : Koska Reeves
Katee Sackhoff Bo-Katan Kryze
Amy Sedaris : Peli Motto
Omid Abtahi : Dr. Pershing
Richard Ayoade : Zero
Daniel Negrete : School Kid
Luke Baines (I) : Pilot
Alexander Wraith : Freighter Pilot
Thomas E. Sullivan : Co-Pilot
Kevin Dorff : Deck Officer
Matthew Wood : Bib Fortuna
Miguel A. Lopez : Juggernaut pilot
Mark Hamill : Luke Skywalker
Titus Welliver Imperial Captain
Richard Brake : Valin Hess
John Leguizamo : Gor Koresh
Rey-Phillip Santos : Magistrate Guard
Simon Kassianides : Axe Woves
Horatio Sanz : Mythrol
Wing Tao Chao : Governor Wing
Dave Filoni : Trapper Wolf
James Croak : Prisoner
Michael Biehn : Lang
Carl Weathers : Greef Karga
Timothy Olyphant : Cobb Vanth
Bill Burr : Mayfeld
Rosario Dawson : Ahsoka Tano
Diana Lee Inosanto : Morgan Elsbeth
Philip Alexander : Security Officer