Pedro Alonso : Berlín / Andrés de Fonollosa
Michelle Jenner : Keila
Tristán Ulloa : Damián Vázquez
Begoña Vargas : Cameron
Julio Peña (III) : Roi
Joel Sánchez : Bruce
Samantha Siqueiros : Camille Polignac
Julien Paschal : François Polignac
Yuri D. Brown : Bertrand
Najwa Nimri : Alicia Sierra Montes
Martin Aslan : Alain
Ruth Llopis : Carmen
Miko Jarry : Olivier
Itziar Ituño : Raquel Murillo Fuentes
Marcos Frutos : Antonio Vals
Rachel Lascar : Marie Lavelle
Adryen Mehdi : Matías
Verónica Gregory : Sofía
Masi Rodríguez : Susie
Belén López : Iris
Enric Benavent : Toureaux
Miguel Tarifa : Fred
Marcel Gonzalez : Jean
Edu Román : Jimmy
Elena Matateyou : Amie de Camille
Javier Collado : Invité de Val
Corentin Huon de Penanster : Philippe Moreau
Mourad Ouani : Voisin de Polignac
Raphael Desprez : Leroy
Thorian-Jackson De Decker : Pierre
Jannik Kloft : Lebron
Juliette Gadrat : Melisa
Massimo Ferroni : Claude
Lis Moreno : Sabrina
Beatriz Grimaldos : Petite amie de Matías
Marc Martínez : Père de Roi
Daniel Bruton Ariza : Pablo
Ivan Garcia : Roi jeune
Tirma Ayerbe : Dr. Clavel

