Pedro Pascal : The Mandalorian , Din Djarin
Carl Weathers : Greef Karga
Aidan Bertola : Young Mandalorian
Werner Herzog : The Client
Nick Nolte : Kuiil
Gina Carano : Cara Dune
Emily Swallow : Armorer
Taika Waititi : IG-11
Giancarlo Esposito : Moff Gideon
Omid Abtahi : Dr. Pershing
Bernard Bullen : Father
Matt Lanter : Davan
Horatio Sanz : Mythrol
Alexandra Manea : Mother
Tait Fletcher : Alpha Trawler
Ryan Watson : Beta Trawler
Sala Baker : Klatooinian Raider Captain
Dave Filoni : New Republic Pilot
Brian Posehn : Speeder Pilot
Deborah Chow : Sash Ketter
Jason Sudeikis : Bike Scout Trooper #1
Trula M. Marcus : Sorgan Farmer
Richard Ayoade : Zero
John Beasley Bartender
Ismael Cruz Cordova : Qin
Eugene Cordero : Stoke
Clancy Brown : Burg
Isla Farris : Winta
Natalia Tena : Xi'an
Ming-Na Wen Fennec Shand
Julia Jones : Omera
Asif Ali (IV) : Caben
Bill Burr : Mayfeld
Jake Cannavale : Toro Calican
Mark Boone Junior : Ranzar Malk
Amy Sedaris : Peli Motto
Adam Pally : Bike Scout Trooper #2