Sam Worthington : Jake Sully
Zoe Saldana : Neytiri
Sigourney Weavere : Grace Augustine
Stephen Lang : Miles Quaritch
Michelle Rodriguez : Trudy Chacon
Giovanni Ribisi : Parker Selfridge
Joel David Moore : Norm Spellman
Wes Studi : Eytukan
CCH Pounder : Moat
Wes Studi : Eytukan
Laz Alonso : Tsu'tey
Dileep Rao : Dr. Max Patel
Matt Gerald : le caporal Lyne Wainfleet
Sean Anthony Moran : Private Fike
Scott Lawrence : le chef d'équipage du Venture Star
James Pitt : le pilote de la navette
Sean Patrick Murphy : Le copilote de la navette
Peter Dillon : Le chef d'équipage de la navette
Kelson Henderson : Le pilote du Dragon Gunship
David Van Horn : Le tireur du Dragon Gunship
Jacob Tomuri : Le navigateur du Dragon Gunship
Julene Renee : Un médecin
Peter Mensah : Akwey
Sean Moran : le soldat Fike
Woody Schultz : Un médecin
Camille Keenan : La serveuse
Kevin Dorman : L'opérateur du tracteur
Dean Knowsley : Le pilote du Samson
Andrew Emilio DeCesare : Un trooper
Leandro Di Salvo : Le pilote du Dragon
Luke Hawker : Un médecin
Logan Pithyou : Un technicien
Daniel Rathbon : Un milicien
Grant Roa : Le videur
Nikie Zambo : Navi
Nick Miller : Un trooper
Christian Di Salvo : un pilote du dragon
Amy Clover : Navi
Jason Whyte : le technicien médical du centre cryogénique
Kelly Kilgour : le soldat emprisonné
Jahnel Curfman : un trooper
Lisa Roumain : un trooper
Noli McCool : Diui












