Pedro Pascal : The Mandalorian , Din Djarin
Katee Sackhoff : Bo-Katan Kryze
Emily Swallow : The Armorer
Tait Fletcher : Paz Vizsla
Shirley Henderson : Anzellan Crew
Parvesh Cheena : Nevarro Copper Droid
Lateef Crowder : The Mandalorian
Brendan Wayne : The Mandalorian
Wesley Kimmel : Ragnar
Carl Weathers : Greef Karga
Sasha Banks : Koska Reeves
Simon Kassianides : Axe Woves
Katy O'Brian : Elia Kane
Charles Baker (II) : Survivor Scout
Giancarlo Esposito : Moff Gideon
Marti Matulis : Vane
Charles Parnell : Survivor Captain
Taika Waititi : IG-12
Misty Rosas : Pirate Coxswain
John Cameron : Kerm
Steve Blum : Zeb
Rick Famuyiwa : Jib Dodger
James Chen : Amnesty Officer G27
Brian Gleeson : Brendol Hux
Deborah Chow : Sash Ketter
Omid Abtahi : Dr. Penn Pershing
Travis Parker : Fleet Command
Max Fowler : Amnesty Officer M34
Jonny Coyne : Warlord
Jodi Long : Warlord
John Ott : Technician
Sunkrish Bala : Amnesty Affairs Officer
Hemky Madera : Warlord
Chris Bartlett : RA-7
Ron Bottitta : Warlord
Max Lloyd-Jones : Lt. Reed
Marco Khan : Warlord
Imelda Corcoran : Warlord
Xander Berkeley : Gillad Pellaeon
Nonso Anozie : Gorlan Shard
Matthew Bellows Amnesty Officer M40
Jason Chu : Mandalorian Judge
Amy Sedaris : Peli Motto
Paul Sun-Hyung Lee : Carson Teva
Jack Black : Captain Bombardier
Tim Meadows : Colonel Tuttle
Lizzo : The Duchess
Taika Waititi : IG-11
Christopher Lloyd : Commissioner Helgait
Temuera Morrison : Clone Troopers
Valarie Pettiford : Aristocrat
Harry Holland : Mon Calamari
Dave Filoni : Trapper Wolf
Stephen Kearin : Aristocrat
Paul Sun-Hyung Lee : Cpt. Carson Teva
Nonso Anozie : Gorian Shard
Joanna Bennett : Quarren Captain
Ahmed Best : Kelleran Beq
Barry Lowin : Quarren Navigator
Norwood Cheek : Aristocrat
Veanne Cox : Aristocrat
Mat Fraser : Pirate Coxswain
Misty Rosas : Snivvian Bartender