Giancarlo Esposito : Leo Pap
Rufus Sewell : Roger Salas
Paz Vega : Ava Mercer
Tati Gabrielle : Hannah Kim
Jai Courtney : Bob Goodwin
Rosaline Elbay : Judy Goodwin
Peter Mark Kendall : Stan Loomis
Niousha Noor : Nazan Abassi
Jordan Mendoza : RJ Acosta
Bubba Weiler : Samuel Toby
Robinne Lee : Lily Vernon
Nate Katsuki : Brad Salas
Tina Benko : Jennifer Helman
Stacey Oristano : Barbara Zitner
Hemky Madera : Carlos
Richard Masur : Dr. Wagner
Stacey Oristano : Barbara Loomis
Hemky Madera : Carlos Sujo
Whit Washing : Ted Gough
Austin Elle Fisher : Hannah Vernon jeune
Max Casella : Taco
S.J. Son : Liz Kim
John Hans Tester : Stefan Thiele
Robinne Lee : Lily
Craig Walker : Samson
Alok Tewari : Javier Zanetti
Jonathan Gregg : Officier Randy Krease
George R. Sheffey : Max Olson
Vickie Tanner : Sarah
Patch Darragh : Andrew Covington
Brandi Bravo : Lucy
James Augustus Lee : Cade
Sathya Sridharan : Rajiv Reddy
Amanda Kristin Nichols : Marisol
Anthony Cede√±o : Mickey
Ishan Gandhi : Reza
Susan Varon : Ma Loomis
Delphi Harrington : Suzanne Grosvenor
Britt Faulkner : Courtney
Karen Tsen Lee : Sakura Salas
Cameron Folmar : Kyle
David Bluvband : Fritz
Rocco Parente : Agent Tony Barelli


