Diego Luna : Cassian Andor
Kyle Soller : Syril Karn
Adria Arjona : Bix Caleen
Stellan Skarsgård : Luthen Rael
Genevieve O'Reilly : Mon Mothma
Denise Gough : Dedra Meero
Varada Sethu : Cinta Kaz
Faye Marsay : Vel Sartha
Elizabeth Dulau : Kleya Marki
Jacob James Beswick : Attendant Heert
Anton Lesser : Major Partagaz
Robert Emms : Lonni Jung
Joplin Sibtain : Brasso
Alastair Mackenzie : Perrin Fertha
Bronte Carmichael : Leida
Fiona Shaw : Maarva Andor
Noof Ousellam : Corv
Alex Ferns : Linus Mosk
Wilf Scolding : Vanis Tigo
Abhin Galeya : Salman Paak
Muhannad Bhaier : Wilmon
Michael Jenn : Supervisor Lagret
Kathryn Hunter : Eedy Karn
Ben Miles Tay Kolma
Ben Bailey Smith : Lieutenant Supervisor Blevin
Lucy Russell Supervisor Grandi
Dave Chapman : B2EMO
Victor Perez : Rashi
Raymond Anum : Nurchi
Duncan Pow : Melshi
Lee Ross : Kloris
Kieran O'Brien : Pegla
James McArdle : Timm Karlo
Gary Beadle : Clem Andor
Clemens Schick : Ham
Alex Lawther : Karis Nemik
Antonio Viña : Kassa
Mensah Bediako : Zinska
Nicholas Moss : Lieutenant Keysax
Zubin Varla : Xanwan
Rasaq Kukoyi : Birnok
Ebon Moss-Bachrach : Arvel Skeen 
Gershwyn Eustache : Jnr Taramyn Barcona
Andy Serkis : Kino Loy
Pamela Nomvete : Jezzi
Brian Bovell : Jemboc
Josef Davies : Xaul
Dave Chapman : B2EMO
Sule Rimi : Lieutenant Gorn
Christopher Fairbank : Ulaf
Rupert Vansittart : Chief Hyne
Jake Lampert : West-3
Jordan Long : West-4
Lucas Bond : Young Cassian
Nick Blood : Corporal Kimzi
Ron Cook : Willi
Abraham Popoola : North-1
Richard Henderson : North-3
Forest Whitaker : Saw Gerrera
Cavin Cornwall : Alien Grappler
Alex Blake : Flob
Malcolm Sinclair : Colonel Yularen
Fraser Ayres : East-1
Richard Dillane : Davo Sculdun
Matt Dunkley : Doctor Mullmoy
Ben Bailey Smith : Lieutenant Supervisor Blevin
Hugh Sachs : Senator Dhow
Aidan Cook : Two Tubes
Lee Boardman : Kravas
Roger Barclay : Captain Elk
Katrina Nare : Windi
Alice Orr-Ewing : Senator Vivyn
James Cooney : Apostle
Michael James (III) : Tech Op #1
Mike Quinn : Dewi
Michael Jenn : Supervisor Larget
Chelsea Edge : Ingenue
Damian Farrell : Freedi
Anton Valensi : Den
Adria Arjona : Bix Caleen
Gavin Spokes : Tenek
Rosalind Halstead : Runai Sculdun
Finley Glasgow : Stekan Sculdun
Adrian Rawlins : Doctor Rhasiv
Richard Katz : Colonel Petigar
Lee Ross : Lee Ross
Tom Reed : Taga
Stephen Wight : Verlo
Denise Gough : Dedra Metro
Joshua James : Doctor Gorst
Martin Ware : Dieu
Stanley Townsend : Jayhold Beehaz
Latesha Wilson : Gani
David Hayman : Aldhani Chieftan
Belle Swarc : Kerri
Michael Jenn : Supervisor LagretSupervisor Lagret
Paul McEwan : Intake Warden
Alex Lawther : Karis Nemik
Matthew Lyons : Dewi Pamular
Michelle Duncan : Roboda Beehaz
Liam Cook : Freedi Pamular
Ian Whyte : Vetch
Alfie Todd : Leaonart Beehaz
Kiran Shah : Granik
Ragevan Vasan : Attendant Felzonis
Aidan Cook : Doctor Quadpaw
Tom Reed (II) : Taga
Nicky Moss : Lieutenant Keysax
...
