Taylor Gray : Ezra
Freddie Prinze Jr. : Kanan
Vanessa Marshall : Hera
Steve Blum : Zeb Orrelios
Tiya Sircar : Sabine
David Oyelowo : Agent Kallus
Lars Mikkelsen : Grand Admiral Thrawn
Mary Elizabeth McGlynn : Governor Arihnda Pryce
Tom Baker (II) : The Bendu
Keone Young : Commander Sato
Dave Filoni : Rebel Trooper
Nika Futterman : Presence
Jim Cummings : Hondo Ohnaka / Imperial Officer #1
Nathan Kress : Wedge Antilles
Dave Filoni : Scout Trooper / Stormtrooper #3
Mario Vernazza : Vult Skerris
Stephen Stanton : Grand Moff Tarkin
Catherine Taber : Numa
Trevor Devall : Hobbie
Dave Filoni Green Five
Ray Stevenson : Gar Saxon
Corey Burton : Gobi Glie
Dave Filoni : Rebel Crewman
Gregg Berger : Kalani
Derek Partridge : Commander Brom Titus
Robin Atkin Downes : Cham Syndulla / Stormtrooper #1
Sam Witwer : Maul
André Sogliuzzo : Captain Slavin
Kevin McKidd : Fenn Rau
Matthew Wood : B1-268 / Battle Droids
Corey Burton : Bridge Officer - 1 Episode : 3
Carole Baillien : Hera
Olivier Cuvellier : Zeb Orrelios
Mélanie Dambermont : Sabine
Mathieu Moreau : Kanan
Laurent Van Wetter : Agent Kallus
Antonio Le Presti : Ezra